17 17 17 17 17 17 17 17 17 17 17 17 17 17 17 17 17 17 17 17 17 17 17 17 17 17 17 17 17 17 17 17 17 17 17 17 17 17 17
17 00 08 08 00 00 00 00 08 00 08 08 00 00 00 00 10 08 00 00 00 00 00 00 08 00 00 00 00 00 11 00 00 00 08 00 00 00 17 
17 00 07 08 07 00 07 00 07 00 07 00 07 00 07 00 07 08 07 00 07 00 07 00 07 00 07 00 07 00 07 00 07 08 07 00 07 00 17 
17 00 00 00 00 08 00 00 00 00 00 00 00 00 08 00 00 00 00 00 00 00 00 00 08 00 00 01 00 00 00 00 00 08 00 00 08 00 17 
17 08 07 00 07 08 07 00 07 00 07 00 07 00 07 00 07 00 07 00 07 00 07 00 07 00 07 00 07 00 07 00 07 08 07 00 07 00 17 
17 08 08 00 01 09 00 00 00 00 08 00 08 00 08 01 00 00 08 00 00 08 00 00 00 08 00 00 00 00 00 01 08 08 00 08 00 01 17 
17 01 07 00 07 00 07 00 07 00 07 09 07 08 07 00 07 00 07 00 07 00 07 00 07 00 07 00 07 00 07 00 07 00 07 00 07 00 17 
17 00 00 00 00 08 08 08 01 01 08 00 00 08 00 00 00 00 00 00 00 00 01 00 00 00 00 00 00 08 08 08 00 00 00 08 00 08 17 
17 08 07 00 07 08 07 00 07 00 07 00 07 00 07 00 07 00 07 08 07 00 07 00 07 00 07 00 07 08 07 00 07 08 07 00 07 00 17 
17 00 08 00 00 08 08 00 00 00 08 08 08 00 00 00 00 00 08 08 00 00 00 00 00 08 00 00 00 08 00 00 01 08 00 00 00 00 17 
17 08 07 00 07 08 07 00 07 00 07 00 07 00 07 00 07 00 07 00 07 00 07 00 07 08 07 00 07 08 07 00 07 08 07 00 07 00 17 
17 08 08 00 00 00 00 00 00 00 00 00 00 01 00 00 00 00 00 00 00 12 00 00 00 00 00 00 01 00 00 00 00 00 00 00 08 08 17 
17 00 08 08 00 00 00 00 08 00 08 08 00 00 00 00 10 08 00 00 00 00 00 00 08 00 00 00 00 00 11 00 00 00 08 00 00 00 17 
17 00 07 08 07 00 07 00 07 00 07 00 07 00 07 00 07 08 07 00 07 00 07 00 07 00 07 00 07 00 07 00 07 08 07 00 07 00 17 
17 17 17 17 17 17 17 17 17 17 17 17 17 17 17 17 17 17 17 17 17 17 17 17 17 17 17 17 17 17 17 17 17 17 17 17 17 17 17