17 17 17 17 17 17 17 17 17 17 17 17 17 17 17 17 17 17 17 17 17 17 17 17 17 17 17 17 17 17 17 17 17 17 17 17 17 17 17
17 00 08 08 00 00 08 00 00 00 00 08 00 00 00 08 00 00 08 00 00 00 00 00 08 00 00 08 00 00 10 08 08 00 00 08 00 00 17 
17 00 07 00 07 00 07 00 07 00 07 00 07 00 07 00 07 08 07 00 07 00 07 00 07 00 07 08 07 00 07 08 07 00 07 08 07 08 17 
17 00 08 08 00 08 00 08 00 00 00 00 00 00 00 08 00 00 00 08 08 08 00 00 00 00 00 08 00 00 00 00 00 00 00 08 01 00 17 
17 00 07 00 07 01 07 00 07 00 07 00 07 08 07 00 07 00 07 08 07 08 07 00 07 00 07 00 07 00 07 00 07 08 07 00 07 00 17 
17 00 08 09 00 08 00 08 00 00 06 00 00 00 00 00 00 08 00 00 01 00 00 00 08 00 01 00 00 00 01 00 00 00 00 00 00 08 17 
17 00 07 00 07 00 07 00 07 00 07 00 07 08 07 08 07 00 07 00 07 08 07 00 07 00 07 00 07 00 07 00 07 08 07 00 07 00 17 
17 08 00 08 01 00 00 00 00 00 01 00 00 00 10 08 01 00 00 00 01 00 00 08 00 00 00 00 08 00 01 00 08 00 00 00 00 00 17 
17 01 07 08 07 00 07 00 07 00 07 00 07 08 07 00 07 00 07 00 07 00 07 08 07 08 07 08 07 00 07 00 07 00 07 01 07 08 17 
17 00 08 08 00 08 00 08 01 00 08 00 00 00 00 00 01 00 00 08 00 00 00 08 00 00 01 08 00 08 08 00 00 08 00 00 00 08 17 
17 01 07 08 07 00 07 08 07 00 07 00 07 00 07 00 07 00 07 00 07 00 07 00 07 00 07 00 07 00 07 00 07 08 07 00 07 01 17 
17 00 08 08 00 00 08 00 00 00 00 08 00 00 00 08 00 00 08 00 00 00 00 00 08 00 00 08 00 00 10 08 08 00 00 08 00 00 17 
17 00 07 00 07 00 07 00 07 00 07 00 07 00 07 00 07 08 07 00 07 00 07 00 07 00 07 08 07 00 07 08 07 00 07 08 07 08 17 
17 00 00 00 00 08 00 00 00 00 08 00 00 00 08 00 00 08 00 08 00 00 00 00 00 08 10 00 08 08 08 00 00 00 00 00 00 00 17 
17 17 17 17 17 17 17 17 17 17 17 17 17 17 17 17 17 17 17 17 17 17 17 17 17 17 17 17 17 17 17 17 17 17 17 17 17 17 17
