17 17 17 17 17 17 17 17 17 17 17 17 17 17 17 17 17 17 17 17 17 17 17 17 17 17 17 17 17 17 17 17 17 17 17 17 17 17 17
17 00 00 00 00 00 08 08 00 00 00 00 00 00 00 00 00 00 00 17 00 00 00 00 00 00 00 00 00 00 00 00 00 00 00 00 00 00 17
17 00 07 00 07 00 07 08 07 00 07 00 07 00 07 00 07 00 07 17 07 00 07 00 07 00 07 00 07 00 07 00 07 00 07 00 07 00 17
17 00 00 00 08 00 00 00 00 00 00 00 00 00 00 00 00 00 00 17 00 00 00 00 00 00 00 00 00 00 00 00 00 00 00 00 00 00 17
17 12 07 00 07 00 07 00 07 00 07 00 07 00 07 00 07 00 07 17 07 00 07 00 07 00 07 00 07 00 07 00 07 00 07 00 07 00 17
17 00 00 08 00 00 08 00 09 00 08 00 00 00 00 00 00 00 00 17 00 00 00 00 00 00 00 00 00 00 00 00 00 00 00 00 00 00 17
17 00 07 00 07 00 07 00 07 00 07 00 07 00 07 00 07 00 07 17 07 00 07 00 07 00 07 00 07 00 07 00 07 00 07 00 07 00 17
17 00 00 00 00 08 00 08 00 00 00 00 00 00 00 00 00 00 00 17 00 00 00 00 00 00 00 00 00 00 00 00 00 00 00 00 00 00 17
17 00 07 00 07 00 07 00 07 00 07 00 07 00 07 00 07 00 07 17 07 00 07 00 07 00 07 00 07 00 07 00 07 00 07 00 07 00 17
17 00 00 00 00 08 00 00 00 00 00 00 00 00 00 00 00 00 00 17 00 00 00 00 00 00 00 00 00 00 00 00 00 00 00 00 00 00 17
17 00 07 00 07 00 07 00 07 00 07 08 07 00 07 00 07 00 07 17 07 00 07 00 07 00 07 00 07 00 07 00 07 00 07 00 07 00 17
17 00 00 00 00 00 00 00 00 00 00 00 00 00 00 00 00 00 00 17 00 00 00 00 00 00 00 00 00 00 00 00 00 00 00 00 00 00 17
17 00 07 00 07 00 07 00 07 00 07 00 07 00 07 00 07 00 07 17 07 00 07 00 07 00 07 00 07 00 07 00 07 00 07 00 07 00 17
17 00 00 00 00 00 08 00 00 00 00 00 00 00 00 00 00 00 00 17 00 00 00 00 00 00 00 00 00 00 00 00 00 00 00 00 00 00 17
17 17 17 17 17 17 17 17 17 17 17 17 17 17 17 17 17 17 17 17 17 17 17 17 17 17 17 17 17 17 17 17 17 17 17 17 17 17 17









